3000000000000
0011000000000
0011001111000
0011001100000
0011001100000
0000001100000
0000001100000
0011001111100
0011001111100
0011000001100
0011000001100
0000000001140
0000000000000